22222222222222222221
22222222222222222221
22222222222222222221
22222222221222222221
22222222222222222221
22222222221222222221
22221222222222222221
22222222222222222221
22222222222222222221
22222222222222222221
22222212222222222221
22222222222222222221
22212222222222222221
22222222222222222221
22222222121222222221
22222222222222222221
22222221222222222221
21222122212222222221
22222222222222222221
11111111111111111111
