Width: 50
Height: 50
Tile Size: 50
5,5,5,5,5,5,5,6,6,6,5,5,5,4,4,5,5,5,5,5,5,5,5,5,5,5,5,5,5,5,5,6,5,5,5,5,5,5,5,5,5,6,6,6,5,5,5,5,5,5
5,5,5,5,5,5,5,5,6,5,5,5,4,4,4,4,5,5,5,5,5,5,5,5,5,5,5,5,5,5,6,6,6,5,5,5,5,5,5,5,5,6,6,6,5,5,5,5,5,5
5,5,5,5,5,5,5,5,5,5,5,4,4,4,4,6,6,5,5,5,5,5,5,5,5,5,5,5,5,5,5,6,5,5,5,5,5,5,5,5,5,5,6,5,5,5,5,5,5,5
5,5,5,5,5,6,5,5,5,5,5,4,4,4,5,6,5,5,5,6,5,5,5,5,5,5,5,5,5,5,3,3,3,5,5,6,5,5,5,5,5,5,5,5,5,5,5,6,5,5
5,5,5,5,6,6,6,5,5,5,5,5,4,4,4,4,5,1,1,6,1,5,5,1,6,5,3,3,3,3,3,3,3,3,3,6,6,5,2,2,5,1,1,5,5,5,6,6,6,5
5,5,5,5,5,4,5,5,5,1,5,6,1,4,4,4,4,4,1,4,1,1,1,1,1,3,3,3,3,3,3,3,3,3,3,2,2,2,2,2,2,1,1,1,5,5,5,6,5,5
5,5,5,5,4,4,4,5,1,1,1,6,6,1,4,4,4,4,4,4,4,1,4,1,4,1,5,5,5,5,5,3,3,3,2,2,2,2,2,2,2,2,1,1,1,1,5,5,5,5
5,5,5,6,6,4,4,4,5,1,6,1,1,1,1,1,4,4,1,5,1,4,4,5,5,5,5,5,5,5,5,5,2,2,2,2,2,2,2,2,2,2,2,2,1,1,1,5,5,5
5,5,5,5,6,4,4,4,5,6,1,1,1,1,1,1,1,1,5,5,5,1,5,5,5,5,5,5,5,5,5,2,2,2,2,2,2,2,2,2,2,2,2,2,2,1,1,6,5,5
5,5,5,6,5,4,4,4,6,5,5,1,5,5,5,1,1,5,5,5,5,5,5,5,5,5,5,5,5,5,2,2,2,2,2,2,2,2,2,2,2,2,2,2,1,1,6,5,6,5
5,5,6,6,6,6,4,4,5,5,5,5,5,5,5,5,1,5,5,5,5,5,5,5,5,5,5,5,5,1,1,2,2,2,2,2,2,2,2,2,2,2,2,6,1,1,6,6,6,6
5,5,5,6,5,5,4,5,4,5,5,5,5,5,5,5,5,5,5,5,5,1,1,1,1,1,1,1,1,1,1,1,1,1,2,2,2,2,2,2,2,2,6,6,1,1,1,6,6,5
5,5,5,5,5,5,5,5,5,5,5,5,5,5,5,5,5,5,5,5,1,1,1,1,1,1,1,1,1,1,1,1,1,2,2,2,2,2,2,2,2,2,6,6,5,1,5,1,1,5
5,5,5,6,5,5,5,5,5,1,5,5,5,5,5,5,5,5,5,5,5,1,1,1,1,1,1,1,1,5,5,5,2,2,2,2,2,2,2,2,2,6,5,5,5,5,5,5,1,1
5,5,5,5,5,5,5,5,5,5,5,5,5,5,5,5,5,5,5,5,5,5,5,5,5,5,5,5,5,5,5,5,5,2,2,2,2,2,2,2,5,5,5,5,5,5,5,1,1,1
5,5,5,5,5,5,5,5,5,5,5,5,5,5,5,5,5,5,5,5,5,5,5,5,5,5,5,5,5,5,2,2,2,2,2,2,2,2,2,5,5,5,5,5,5,5,5,6,1,1
5,6,6,5,5,6,5,5,1,5,5,5,5,5,5,5,5,5,5,5,5,5,5,5,5,5,5,5,5,2,2,2,2,2,2,2,2,5,5,5,5,5,5,5,5,1,6,6,1,1
5,5,6,5,5,5,5,5,6,1,1,5,5,5,5,5,5,5,5,5,5,5,5,5,5,5,5,2,2,2,2,2,2,2,2,2,5,5,5,5,5,5,5,6,1,1,1,6,1,1
5,5,5,5,5,5,5,5,5,5,5,6,5,5,5,5,5,5,5,5,5,5,5,5,2,2,2,2,2,2,2,2,2,2,2,5,5,5,5,5,5,5,1,1,1,1,1,1,1,1
5,5,6,5,5,5,5,5,5,5,6,5,5,5,5,5,5,5,5,1,1,1,1,2,2,2,2,2,2,2,2,2,2,2,5,5,5,5,5,5,5,5,1,1,1,1,1,6,1,5
5,6,6,6,5,5,5,5,6,6,5,6,5,5,5,5,5,5,1,1,2,2,2,2,2,2,2,2,2,2,2,2,5,5,5,5,5,5,5,5,5,1,1,1,1,1,1,6,5,5
5,5,6,5,5,5,5,6,6,5,5,5,5,5,5,5,5,5,1,2,2,2,2,2,2,2,2,2,2,2,2,5,5,5,5,5,5,5,5,5,5,5,6,5,6,1,5,6,5,5
5,5,5,5,5,5,5,5,6,5,5,5,5,5,5,5,5,5,2,2,2,2,2,2,2,2,2,2,2,2,5,5,5,5,5,5,5,5,5,5,5,6,6,6,6,6,6,6,6,5
5,5,5,5,5,5,5,5,6,5,5,5,5,5,5,5,5,5,5,2,2,2,2,2,2,2,2,2,2,2,2,5,5,5,5,5,5,5,5,5,5,5,6,6,6,6,6,6,6,6
6,5,5,5,5,5,5,5,5,5,5,5,5,5,5,5,5,5,5,5,2,2,2,2,2,2,2,2,2,2,2,5,5,5,5,5,5,5,5,5,5,6,6,6,6,6,6,6,6,5
6,6,5,5,5,5,5,5,5,4,5,5,5,5,5,5,5,5,5,5,5,2,2,2,2,2,2,2,2,2,5,5,5,5,5,5,5,5,5,5,6,5,5,6,6,6,6,6,5,5
6,5,5,5,5,5,5,5,5,6,5,5,5,5,5,5,5,5,5,5,5,2,2,2,2,2,2,2,2,5,5,5,5,5,5,5,5,5,5,5,5,6,6,6,6,6,6,6,6,5
5,5,5,5,5,5,5,5,5,5,4,5,5,5,5,5,5,5,5,5,5,5,2,2,2,2,5,5,5,5,5,5,5,5,5,5,5,5,5,5,6,6,6,6,6,6,6,6,6,6
5,5,5,5,5,5,5,6,5,5,5,4,5,5,5,4,1,5,5,5,5,5,5,5,5,5,5,5,5,5,1,5,6,1,6,5,5,5,5,6,5,6,6,6,6,6,6,6,6,6
5,5,5,5,5,5,6,6,6,5,6,5,4,5,4,4,4,1,1,5,5,5,5,5,1,1,5,1,5,1,1,1,1,6,6,5,6,6,6,5,5,5,6,5,6,6,6,6,6,6
6,5,5,5,5,5,5,6,5,6,6,6,5,5,4,4,1,1,1,1,5,4,1,1,1,1,1,1,1,1,1,1,6,6,6,6,6,6,6,6,5,6,6,6,5,6,6,6,5,6
6,6,5,5,5,5,5,5,5,5,6,5,5,1,1,1,1,1,1,1,1,1,1,1,1,1,1,1,1,1,1,6,6,6,6,5,6,6,6,6,5,5,6,5,5,5,5,6,5,5
6,5,5,5,5,5,5,5,5,5,5,5,1,1,1,1,1,1,1,1,1,1,1,1,1,1,1,1,6,6,6,5,6,6,6,5,6,5,6,5,5,5,6,5,5,6,6,6,6,5
5,5,5,5,5,5,5,5,5,5,5,5,5,1,1,1,5,6,6,1,1,1,1,1,1,1,5,6,6,6,5,6,6,6,5,6,6,6,6,6,5,6,6,6,6,6,6,6,5,5
5,5,5,5,5,5,5,5,5,5,5,5,5,5,6,5,6,6,6,6,1,1,5,6,5,5,6,5,6,6,6,6,6,6,5,6,6,6,6,5,6,6,6,6,5,6,5,5,5,5
5,5,5,5,5,5,5,5,5,5,5,5,5,5,5,5,5,6,6,6,6,6,5,5,5,6,6,6,6,6,6,6,6,6,6,6,6,6,6,6,6,6,6,5,5,5,5,5,5,5
5,5,5,5,5,5,5,5,5,5,5,5,5,5,5,5,5,6,6,6,6,6,6,5,5,5,6,5,6,6,5,5,5,6,6,6,6,6,6,6,6,5,5,6,5,5,5,5,5,5
5,5,5,5,5,5,5,5,5,5,5,5,5,5,5,5,5,5,6,5,5,6,5,5,5,6,6,6,6,6,6,5,5,6,6,6,6,6,6,5,5,5,6,6,6,6,5,5,5,5
5,5,5,5,5,5,5,5,5,5,5,5,5,5,5,5,5,5,5,5,5,5,5,5,5,6,6,6,6,6,6,6,6,6,6,6,6,6,6,6,5,5,5,6,6,6,6,5,5,5
5,5,5,5,5,5,5,5,5,5,5,5,5,5,5,6,5,5,5,5,5,5,5,5,5,6,6,5,6,5,6,6,6,6,6,6,6,6,6,6,5,5,5,5,6,6,6,5,5,5
5,5,5,5,5,5,5,5,5,5,5,5,5,5,6,6,6,5,5,5,5,6,5,5,6,6,6,6,6,6,5,6,6,6,6,6,6,6,6,5,5,6,5,5,5,6,5,5,5,5
5,5,5,5,5,5,5,5,5,5,5,5,5,5,5,6,5,5,5,5,6,6,6,5,5,6,6,6,6,5,6,6,6,6,6,6,6,6,5,5,6,6,6,5,5,5,5,5,5,5
5,5,5,5,5,5,5,5,5,5,5,5,5,5,6,6,5,5,5,5,6,6,6,6,5,5,5,6,5,5,5,6,6,6,6,6,6,5,5,5,5,6,5,5,5,5,5,5,5,5
5,5,5,5,5,5,5,5,5,5,5,5,5,6,6,6,6,5,5,6,6,6,6,6,6,5,6,6,6,5,5,5,5,6,6,6,5,5,5,5,5,5,5,5,5,5,5,5,5,5
5,5,5,5,5,5,5,5,5,5,5,5,5,5,6,6,5,5,5,5,6,5,6,6,5,5,5,6,5,5,5,5,5,5,6,5,5,5,5,5,5,5,5,5,5,5,5,5,5,5
5,5,5,5,5,5,5,5,5,5,5,5,5,5,5,5,5,5,5,5,5,5,5,5,5,5,5,5,5,5,5,5,5,5,6,5,5,5,5,5,5,5,5,5,5,5,5,5,5,5
5,5,5,5,5,5,5,5,5,5,5,5,5,5,5,5,5,5,5,5,5,5,5,5,5,5,5,5,5,5,5,5,5,6,6,6,5,5,5,5,5,5,5,5,5,5,5,5,5,5
5,5,5,5,5,5,5,5,5,5,5,5,5,5,5,5,5,5,5,5,5,5,5,5,5,5,5,5,5,5,5,5,5,5,6,5,5,5,5,5,5,5,5,5,5,5,5,5,5,5
5,5,5,5,5,5,5,5,5,5,5,5,5,5,5,5,5,5,5,5,5,5,5,5,5,5,5,5,5,5,5,5,5,5,5,5,5,5,5,5,5,5,5,5,5,5,5,5,5,5
5,5,5,5,5,5,5,5,5,5,5,5,5,5,5,5,5,5,5,5,5,5,5,5,5,5,5,5,5,5,5,5,5,5,5,5,5,5,5,5,5,5,5,5,5,5,5,5,5,5
