Width: 50
Height: 50
Tile Size: 50
0,0,0,3,3,3,3,3,3,3,3,3,3,3,3,3,3,3,0,0,0,0,0,0,0,0,0,0,0,0,0,0,0,0,0,0,0,0,0,0,0,0,0,0,0,0,0,0,0,0
0,0,0,3,1,1,1,1,1,1,1,1,1,1,1,1,1,3,0,0,0,0,0,0,0,0,0,0,0,0,0,0,0,0,0,0,0,0,0,0,0,0,0,0,0,0,0,0,0,0
0,0,0,3,1,1,1,3,3,3,3,3,1,1,1,1,1,3,0,0,0,0,0,0,0,0,0,0,0,0,0,0,0,0,0,0,0,0,0,0,0,0,0,0,0,0,0,0,0,0
0,0,0,3,1,1,1,1,1,1,1,1,1,3,3,3,3,3,0,3,3,3,3,3,3,3,3,3,3,3,3,3,3,3,3,3,3,3,3,3,3,3,3,3,3,3,3,3,3,3
0,0,0,3,1,1,1,1,1,1,1,1,1,3,1,1,1,3,0,3,2,2,2,2,2,2,2,2,2,2,2,2,2,2,2,2,2,2,2,2,2,2,2,2,3,2,2,2,2,3
0,0,0,3,1,3,1,1,1,3,1,1,1,3,1,1,1,3,0,3,2,2,2,3,2,2,2,2,2,2,3,2,2,2,2,2,2,3,2,2,2,2,2,2,3,2,2,2,2,3
0,0,0,3,1,3,1,1,1,3,1,1,1,3,1,1,1,3,0,3,2,2,2,3,2,2,2,2,2,3,3,2,2,2,2,2,2,3,2,2,2,2,2,2,3,2,2,2,2,3
0,0,0,3,1,3,1,1,1,3,3,3,3,3,1,1,1,3,0,3,3,3,3,3,2,2,2,2,2,3,2,2,2,2,2,2,2,3,2,2,2,2,2,2,3,3,3,3,2,3
0,0,0,3,1,3,1,1,1,3,1,1,3,1,1,1,1,3,0,3,2,2,2,2,2,2,2,2,2,2,2,2,2,2,2,2,2,2,2,2,2,2,2,2,2,2,2,2,2,3
0,0,0,3,1,3,3,3,3,3,1,1,3,1,1,1,1,3,0,3,2,2,2,2,2,2,2,2,3,3,3,3,3,3,2,2,2,3,3,3,3,3,3,2,2,2,2,2,2,3
0,0,0,3,1,1,1,1,1,1,1,1,3,1,1,1,1,3,0,3,2,3,3,2,2,2,2,2,3,2,2,2,2,2,2,2,2,2,2,2,2,2,3,2,2,2,2,2,2,3
0,0,0,3,1,1,1,1,1,1,1,1,3,1,1,1,1,3,0,3,2,2,3,2,2,2,2,2,3,2,2,2,2,2,3,3,3,2,2,2,2,2,3,2,2,2,2,2,2,3
0,0,0,3,1,1,1,1,1,1,1,1,3,1,1,1,1,3,3,3,2,2,3,2,2,2,2,2,3,2,2,2,2,2,2,2,2,2,2,2,2,2,3,2,2,2,2,2,2,3
3,3,3,3,3,3,3,3,1,1,1,3,3,3,3,1,1,1,1,1,2,2,2,2,2,2,2,2,3,2,3,3,3,2,2,2,2,2,2,2,2,2,3,2,2,2,2,2,2,3
1,1,1,1,1,1,1,3,1,1,1,3,1,1,3,1,1,1,1,1,2,2,2,2,2,2,2,2,3,2,2,2,2,2,2,2,2,2,3,3,3,2,3,2,2,2,2,2,2,3
1,1,1,1,1,1,1,3,1,1,1,3,1,1,3,1,1,1,1,1,2,2,2,2,2,2,2,2,3,2,2,2,2,2,2,2,2,2,2,2,2,2,3,2,3,3,3,2,2,3
1,1,1,1,1,1,1,3,1,1,3,3,1,1,3,1,1,3,3,3,2,2,2,2,2,2,2,2,3,3,3,3,3,3,3,3,3,3,3,3,3,3,3,2,2,2,3,2,2,3
3,3,3,3,1,1,1,1,1,1,3,1,1,1,3,1,1,3,0,3,2,2,2,2,2,2,2,2,2,2,2,2,2,2,2,2,2,2,2,2,2,2,2,2,2,2,3,2,2,3
0,0,0,3,1,1,1,1,1,1,1,1,1,1,1,1,1,3,0,3,2,2,2,3,3,3,3,3,2,2,2,2,2,2,2,2,2,2,2,2,2,2,2,2,2,2,3,2,2,3
0,0,0,3,1,3,3,3,3,3,3,1,1,1,1,1,1,3,0,3,2,2,2,3,2,2,2,2,2,2,2,2,2,2,2,2,2,2,2,2,2,2,2,2,2,2,2,2,2,3
0,0,0,3,1,1,1,1,1,1,3,1,1,1,1,1,1,3,0,3,2,2,2,3,2,2,2,2,2,2,2,2,2,2,2,3,3,3,3,2,2,2,2,2,3,2,2,2,2,3
0,0,0,3,1,1,1,3,3,1,3,1,1,1,1,1,1,3,0,3,2,2,2,3,2,2,2,2,2,3,2,2,3,2,2,2,2,2,3,2,2,2,2,2,3,2,2,2,2,3
0,0,0,3,1,1,1,1,3,1,3,3,3,3,3,1,1,3,0,3,2,2,2,3,2,2,2,2,2,3,2,2,3,2,2,2,2,2,3,2,2,2,2,2,3,2,2,2,2,3
0,0,0,3,1,1,1,1,1,1,3,1,1,1,1,1,1,3,0,3,2,2,2,3,3,3,2,2,2,3,2,2,3,2,2,2,2,2,3,2,2,2,2,2,3,2,2,2,2,3
0,0,0,3,3,3,3,3,1,1,3,3,3,3,1,1,1,3,0,3,2,2,2,2,2,2,2,2,2,3,3,3,3,2,2,2,2,2,2,2,2,2,2,2,2,2,2,2,2,3
0,0,0,3,1,1,1,3,1,1,1,1,1,3,3,3,1,3,0,3,2,2,2,2,2,2,2,2,2,2,2,2,2,2,2,2,2,2,2,2,2,2,2,2,2,2,2,2,2,3
0,0,0,3,1,1,1,3,3,1,1,1,1,3,1,1,1,3,0,3,2,2,2,2,2,2,2,2,2,2,2,2,2,2,2,2,2,2,2,2,2,2,2,2,2,2,2,2,2,3
0,0,0,3,1,1,1,1,3,3,3,1,1,3,1,1,1,3,0,3,3,3,3,3,3,3,3,3,3,3,3,3,3,3,3,2,2,2,3,3,3,3,3,3,3,3,3,3,3,3
0,0,0,3,1,1,1,1,1,1,1,1,1,3,3,3,3,3,0,0,0,0,0,0,0,0,0,0,0,0,0,0,0,0,3,2,2,2,3,0,0,0,0,0,0,0,0,0,0,0
0,0,0,3,1,3,3,1,1,1,1,1,1,3,1,1,1,3,0,0,0,0,0,0,0,0,0,0,0,0,0,0,0,0,3,2,2,2,3,0,0,0,0,0,0,0,0,0,0,0
0,0,0,3,1,1,3,3,3,3,3,3,3,3,1,1,1,3,0,0,0,0,3,3,3,3,3,3,3,3,3,3,3,3,3,4,4,4,3,3,3,3,3,3,3,3,3,3,3,3
0,0,0,3,1,1,1,1,1,1,1,1,1,1,1,1,1,3,0,0,0,0,3,4,4,4,4,4,4,4,4,4,4,4,4,4,4,4,4,4,4,4,4,4,4,4,4,4,4,3
0,0,0,3,3,3,3,3,3,3,3,3,3,3,3,3,3,3,0,0,0,0,3,4,4,4,4,4,4,4,4,4,4,4,4,4,3,4,4,4,4,4,4,4,4,4,4,4,4,3
0,0,0,0,0,0,0,0,0,0,0,0,0,0,0,0,0,0,0,0,0,0,3,4,4,4,4,4,4,4,4,4,4,4,4,4,3,4,4,4,4,4,4,4,4,4,4,4,4,3
3,3,3,3,3,3,3,3,3,3,3,3,3,3,3,3,3,3,3,3,3,0,3,4,4,4,4,4,4,4,4,4,4,4,4,4,3,4,4,4,4,4,4,4,4,4,4,4,4,3
3,4,4,4,4,4,4,4,4,4,4,4,4,3,4,4,4,4,4,4,3,0,3,4,4,4,3,3,3,3,4,4,4,3,4,4,4,4,4,4,4,4,3,4,4,4,4,4,4,3
3,4,4,4,4,4,4,4,4,4,4,4,4,3,4,4,3,4,4,4,3,0,3,4,4,4,3,4,4,4,4,4,4,3,4,4,4,4,4,4,4,4,3,4,4,4,4,4,4,3
3,4,4,4,4,4,4,4,4,4,4,4,4,3,4,4,3,4,4,4,3,0,3,4,4,4,3,4,4,4,4,4,4,3,4,4,4,3,3,3,4,4,3,4,4,4,4,4,4,3
3,4,4,4,4,4,4,4,4,4,4,4,4,3,3,3,3,4,4,4,3,0,3,4,4,4,3,4,4,4,4,4,4,3,4,4,4,4,4,4,4,4,3,4,4,4,4,4,4,3
3,4,4,4,4,4,4,4,4,4,4,4,4,4,4,4,4,4,4,4,3,3,3,4,4,4,3,4,4,4,4,4,4,3,4,3,3,3,4,4,4,4,3,4,4,4,4,4,4,3
3,4,4,4,3,3,3,3,3,4,4,4,4,4,4,4,4,4,4,4,4,4,4,4,4,4,3,3,3,3,4,4,4,3,4,4,4,4,4,4,4,4,3,4,4,4,4,4,4,3
3,4,4,4,4,4,4,4,3,4,4,4,4,4,4,4,4,4,4,4,4,4,4,4,4,4,4,4,4,4,4,4,4,3,4,4,4,4,4,4,4,4,3,4,3,3,3,4,4,3
3,4,4,4,4,4,4,4,3,4,4,4,4,4,4,4,4,4,4,4,4,4,4,4,4,4,4,4,4,4,4,4,4,3,3,3,3,3,3,3,3,3,3,4,3,4,4,4,4,3
3,4,4,4,4,4,4,4,3,4,4,4,4,3,4,4,4,4,4,4,3,3,3,4,4,4,3,4,4,4,4,4,4,4,4,4,4,4,4,4,4,4,4,4,3,4,4,4,4,3
3,4,4,4,3,3,3,3,3,4,4,4,4,3,4,4,4,4,4,4,3,0,3,4,4,4,3,4,5,5,4,4,4,4,4,4,4,4,4,4,4,4,4,4,3,3,3,4,4,3
3,4,4,4,4,4,4,4,4,4,4,4,4,3,4,4,4,4,4,4,3,0,3,4,4,4,3,5,5,5,4,4,4,4,4,3,4,4,4,3,4,4,4,4,4,4,4,4,4,3
3,4,4,4,4,4,4,4,4,4,4,4,4,3,3,3,4,4,4,4,3,0,3,4,4,4,3,4,4,5,4,4,4,4,4,3,4,4,4,3,4,4,4,4,4,4,4,4,4,3
3,4,4,4,4,4,4,4,4,4,4,4,4,4,4,4,4,4,4,4,3,0,3,4,4,4,4,4,4,4,4,4,4,4,4,3,3,3,3,3,4,4,4,4,4,4,4,4,4,3
3,4,4,4,4,4,4,4,4,4,4,4,4,4,4,4,4,4,4,4,3,0,3,4,4,4,4,4,4,4,4,4,4,4,4,4,4,4,4,4,4,4,4,4,4,4,4,4,4,3
3,3,3,3,3,3,3,3,3,3,3,3,3,3,3,3,3,3,3,3,3,0,3,3,3,3,3,3,3,3,3,3,3,3,3,3,3,3,3,3,3,3,3,3,3,3,3,3,3,3
